R         1080       600

NO                                         ./textures/brick.xpm
SO ./textures/lego.xpm
WE ./textures/kandinsky.xpm
EA ./textures/binary
S ./textures/crate.xpm

F 50,50,50
C 128,0,0

1111111111111111
1100002000000001
1000000111110001
1002001002020001
1000021002111111
1020001002000201
1000111110020021
1000100011111001
1000100010000001
1000100010001111
1000000010000001
10000000100S0001
1000000010000001
101101111000001111
1000000000000000201
110111111111111111
1101111111111111
1100002000000001
10N0000111110001
1002001002020001
1000021002111111
1020001002000201
1000111110020021
1000100011111001
1000100010000001
1000100010001111
1000000010000001
1000000010000001
1000000010000001
101101111000001111
1000000000000000201
111111111111111111