R 1920 1080

NO ./textures/brick.xpm
SO ./textures/lego.xpm
WE ./textures/kandinsky.xpm
EA ./textures/binary.xpm
S ./textures/sprite.xpm

F 50,50,50
C 10,10,10

1111111111111111
1E00000000000001
1000000111110001
1000001000000001
1000001000111111
1000001000000001
1000111110000001
1000100011111001
1000100010000001
1000100010001111
1000000010000001
1000000010000001
1000000010000001
1011011110000001
1000000000000001
1111111111111111