R 1920 1080

NO ./textures/brick.xpm
SO ./textures/lego.xpm
WE ./textures/kandinsky.xpm
EA ./textures/binary.xpm
S ./textures/crate.xpm

F 50,50,50
C 10,10,10

1111111111111111
1E00002000000001
1000000111110001
1020001000000001
1020001000111111
1020001000000001
1020111110000001
1000100011111001
1000100010000001
1000100010001111
1020000010000001
1000000010000001
1000000010000001
1011011110000001
1000000000000001
1111111111111111