R 512 512

NO ./path_to_the_north_texture
SO ./path_to_the_south_texture
WE ./path_to_the_west_texture
EA ./path_to_the_east_texture
S ./path_to_the_sprite_texture

F 220,100,0
C 225,30,0

1111111111111111
1000000000000001
1000000111110001
1000001000000001
1000001001111111
1000001000000001
1000111110000001
1000100011111001
1000100010000001
1000100010011111
1000000010000001
1000N00010000001
1000000010000001
1011111110000001
1000000000000001
1111111111111111